#############################################################################################################################################
#.....#.....#...#.................#...#.......#.........#...#.......#...#.......#.......#...#...#.....#...#.......................#...#....E#
#.###.#.#.#.###.#.###.###.#######.#.#.#.#.###.#.###.###.#.#.#.###.#.###.#.#.#####.###.#.###.#.#.#.#.#.#.#.#.#####.#.###.#.#######.#.#.#.###.#
#...#.#.#.#...#.....#...#.#.....#...#...#.#...#.#...#...#.#.#...#.#...#.#.#...#...#...#.....#.#.#.#.#...#...#.....#.#.#.....#.....#.#.#...#.#
#.#.###.#.###.#.#####.#.#.###.###########.#.#####.###.###.###.###.###.#.#.#.#.#.###.#######.#.#.#.#.#########.#####.#.#.#####.#####.#.###.#.#
#.#.....#.#.#.#...#...#.#...#.....#.....#.#.....#.#.#.#.........................#.#.......#.#.#...#.....#...#.#...#.....#...#.#...#.#.....#.#
#.#######.#.#.#.###.#.#.###.#.#.#.#.#.###.#####.#.#.#.#.###.###.###.#.###.#.#.#.#.#######.###.#.#####.#.#.#.#.###.###.#.#.#.#.#.#.#.#######.#
#...#...#.#...#.#...#.#...#.#.#.#...#.#.......#...#...#...#...#.#.....#...#.#...#.......#...#...#.....#...#.#.....#...#...#...#.#.........#.#
###.#.###.#.#####.###.###.#.###.#.#####.###.#.#####.###.#.###.#.###.###.###.#####.#########.#.#.###.#.###.#.#####.#.###.#######.###########.#
#...#...#.#.#.....#...#...#.#...#.#...#.#...#.#...#...#.#.....#...#...#.#...........#.........#.#...#.#...#.........#.#.#.......#...........#
#.#####.#.#.#.#######.#.###.#.###.#.#.#.#.###.#.#####.#########.#.#.###.#.#####.###.#.#####.#.#.#.###.###.###.#####.#.#.#.#######.#########.#
#.#.....#.#...#.......#...#.#.#.....#.#...#.#.#...............................#...#.#...#...#...#.#.#.....#.#.....#...#.#.#.....#.......#...#
#.#.###.#.#####.#.###.###.#.#.#.#.###.#.###.#.###############.#.#.#.#.#####.#.#####.###.#####.#.#.#.#####.#.#####.###.#.#.#.###.#######.###.#
#.#...#.#.....#.#.....#...#...#.#...#.#.....#.#.....#.................................#...#...#...#...#...................#...#...#...#...#.#
#.###.#.#####.###.#.#.#.#####.#.#.#.#.#######.#.###.#.#######.###.#.#.#.#.###.#.#########.#.#.#.#.#.###.#.#####.#.###.#.#.###.#.#.###.###.#.#
#.#...............#.#...#...#.#...#.........#.....#.#.#.......#...#.#.#.#.#...#.#.....#...#.#.....#.....#.....#.#.....#.#.#...#.#...#...#...#
#.#.#####.#.#####.#.#####.#.#.###.#########.#.#####.#.#.#######.###.#.###.#.###.#.###.#.#.#.#.#########.#.###.#########.#.#####.###.###.###.#
#.#.#.....#.....#.#.#.....#.....#.....#...#.#.#.....#.#.#.......#.#.#.....#.#...#.#...#.#.#.#.........#...#.#.........#.#.........#...#...#.#
#.#.#.#####.#####.#.###.#######.#####.###.#.###.#####.#.#####.###.#.#######.#.#.#.#.#.#.###.#.#######.#.###.###.#.###.#.#########.###.#.#.#.#
#.#.......#...#...#...#...#...#.....#...#.#.#...#.#.....#.....#.....#...#...#.#...#.#.#.....#.#.......#.#.......#...#.#.....#.......#.#.....#
#.#######.###.#.#####.#.###.#.#########.#.#.#.###.#.#####.###.#######.#.#.#########.#.###.###.#.#######.#.#####.###.#.#####.#.###.###.#.#.#.#
#.....#...#...#...#.#.#.#...#.#.........#.#...#...#...#...#.#.#.......#...#.......#.#.#.......#.........#.........#.#...#.#.#...#.....#.#.#.#
#####.###.#.#.###.#.#.###.###.#.#########.#####.#####.#.#.#.#.#.#############.###.#.#.###########.#######.#######.#.#.#.#.#.###.#######.#.#.#
#...#...#.#.#.#...#.......#.#.#.#.......#.......#.....#.#.#...#.............#.#...#.#...#.......#.........#...#...#...#...#...#...#.....#.#.#
#.#.###.#.#.#.#.###########.#.#.###.###.#.#.#####.#####.#.#####.#.#########.#.#.###.###.#.###.#.###########.###.#####.###.#.#####.#.#####.#.#
#.#.#.#.#.#.#.#.....#.....#...#...#.#.....#.#.....#.#...#.....#.#.#.......#.#.#...#.#.....#...#.#.....#.....#...#.......#.#.................#
#.#.#.#.###.#.#####.#.###.#.#####.#.#######.#.#####.#.#####.#.#.#.#####.###.#.###.#.#########.#.#.###.#.###.#.###.#####.#.###.###.###.#.###.#
#.....#.#...#.....#...#...#...#...#.#.....#.#...#.#...#.....#...#.#.....#...#.#...#...#.......#...#...#...#.#.#...#.....#.#.#.........#...#.#
#.#####.#.#######.#####.#####.#.###.#.###.#####.#.#.#####.#.#####.#.#####.###.#.#####.#.###.#######.#######.#.###.#.#####.#.###############.#
#.#.....#...#...#...#...#.....#.#...#.#.#.......#.#.......#.....#.#.....#.#...#.......#.#...#.......#.....#.#.....#.....#.......#.........#.#
#.#.#######.#.#.###.#.#######.#.#.###.#.#########.#############.#.#.###.#.#.###.#########.#.#.#########.#.#.#####.#####.#####.###.#######.#.#
#...#.....#...#...#.#.......#...#...#...#.........#.......#...#...#...#.#.#...#.#...#...#.#.#.#.....#...#.#.....#.....#.....#.#...#.....#...#
#.###.#.#.#.#####.#########.###.###.###.###.###.#.#.###.#.#.#.#########.#.#.#.###.#.#.#.#.###.#.###.#.###.#.#.#######.#####.#.#.###.#.#####.#
#.#.....#.#.#...#...#.......#.............#.#.#.#.#.#...#...#.#.........#.#.#.....#.#.#.#.#.....#.....#.#.#.#...........#...#.#...#.#.#...#.#
#.#.#.###.###.#.###.#.#########.#####.###.#.#.#.#.#.#.#########.#.#####.#.#########.#.#.#.#.#######.###.#.###########.###.###.###.#.###.#.#.#
#...#...#.....#.....#.#.........#.....#...#.....#.#.#.#.....#...#.#...#.#.#.......#...#.#...#.#...#...#...#.............#.#...#...#.....#.#.#
#####.#.#######.#####.#.#.#############.#####.#.###.#.#.###.#.###.#.#.###.#.#####.#####.#.###.#.#.#.#.#.###.###########.#.###.#.###.#####.#.#
#.#...#.......#.#.....#.#.#...#.............#.#.#...#.....#.....#...#...#.#...#.#...#...#.#...#.#.#.#.#...#.#...#.....#.#.#.....#...#...#...#
#.#.#.###.#####.#.#####.###.#.#.###########.###.#.#############.#######.#.###.#.###.#.###.#.###.#.#.#.#.#.#.#.#.#.#####.#.#.#.###.###.#.#####
#...#...#...#...#.#.#.......#.#.#.......#.....#.....#.........#.........#...#.#.....#...#...#...#.#.#.#.....#.#.#.........#.#.#...#...#.#...#
#.###.#.###.#.###.#.#.#######.#.#.#####.#####.#.#####.#######.#.#####.#.###.#.#.#######.###.#.###.#.###.###.#.#.#.#########.#.#.#####.#.#.#.#
#.......#...#...#.#.........#...#...#.#.....#.#...#...#.#.....#.#.....#...#...#...#...#.....#...#.#.....#.....#.#.#.........#.#.......#.#.#.#
#.###.#.#.###.#.#.###.#########.###.#.#####.#.#####.###.#.#######.#######.#######.#.#.#.###.###.#.#.#####.#####.#.#.#########.#########.#.###
#.#.....#.....#.#...#.#.......#.#...#.....#.#.......#.....#.......#...#.....#...#...#.#.#...#...#.#.#.....#...#.#.#.#.........#.....#...#...#
#.#.#.#######.#.#.#.###.#.###.###.###.#####.#.#.###.#.#########.#.#.#.#.#####.#.###.#.###.#.#.###.###.#####.#.#.###.#.#####.###.###.#.###.#.#
#.#.#.....#...#.#.#.#...#...#.#...#.....#...#.........#.........#.#.#.#.#.....#.....#.#...#...#.#...........#.#...#.#.#...#.......#.#...#.#.#
#.#.#.###.#.#.#.#.#.#.#####.#.#.#######.#.###.#########.#.###.#####.#.###.#####.#####.#.###.###.#######.#########.#.###.#.#####.#.#.###.###.#
#.#.#.....#.#.#.#.#.#.......#.#.#...#...#.#.#...#.#.....#.#...#.........#...#...#...#.#.#...#...#.....#.#.....#...#.....#.#.....#.#.........#
#.#.#.###.#.#.#.#.#.#.#.#.#.#.#.#.#.#.###.#.###.#.#.#####.#####.###.###.###.#.###.#.#.#.#.###.#.#.###.###.###.#.#.#####.#.#.###.#.#########.#
#.#.......#.#.#...#.#.#.#.#.#.#...#.#.#...#.#...#...#...#.#...#...#...#...#.#.....#.#.#.#.#...#.#.#...#...#.#.#.#.........#...#.#.....#...#.#
#.#######.#.#.###.#.#.#.#.###.#####.#.#.###.#.#####.#.#.#.#.#.###.###.###.#.#######.#.#.#.#.#####.#.###.###.#.#.#####.#.#####.#.#######.#.#.#
#.#.......#.#...#.#.#...#...#.#.......#.#...#.....#.#.#...#.#...#.....#.#.#.......#...#.....#.....#...#.#.....#.....#.#.#.....#.........#.#.#
#.#.#####.#.###.#.#.#.#.###.#.#.#######.#.#.#####.#.#.###.#.###.#.###.#.#.#######.###########.#######.#.#.#########.###.#.###############.#.#
#.#...#...#.#...#.#...#.#...#...#.#.....#.#.#.....#.#.#...#...#.........#...................#.#.....#.#.#.........#...#...#.......#.......#.#
#.###.#.#.#.#####.###.###.#.#####.#.#####.#.#.#####.#.#.#####.#########.###################.#.#.#####.#.###.###.#.###.#####.#######.#######.#
#...#...#...#.....#.......#.....#.#.#.....#...#.........#...#...#.....#...#...........#.#.....#.......#...#.....#.......#...#.....#.#.....#.#
###.###.#.###.#####.###########.#.#.#.###########.#.#####.#.###.#.###.###.#.#########.#.#.#######.#####.#.###########.#.#.#.#.###.#.###.###.#
#...#...#...........#.#.....#.....#.#.#.......#...#.#.....#.....#.#.#.#...#.#.#.....#.#.....#...#.....#.#.................#.#.#.#.#...#.....#
#.#.#.#####.###.#####.#.###.#.###.#.#.###.###.#.#####.#######.###.#.#.#####.#.#.#.###.#.#####.#.#####.#####.#########.#####.#.#.#.#.#.###.###
#.#.#.#...#.#.......#.....#.....#.#.#.#...#.#.#.......#.....#...#.#.#...#.......#.....#...#...#.#...#.....#.........#...#...#.#...#.#...#...#
#.###.#.#.###.###.#.###########.#.#.#.#.###.#.#.#.#####.###.###.#.#.###.#.#########.#######.###.###.#####.#########.###.#.###.#.#######.#####
#.#...#.#.....#...#.#.........#...#.#...#...#.#.....#...#...#...#.#.#...#.........#.........#.#.#...#...#...#.....#...#.#...#.#...#...#.....#
#.#.###.#.#####.#.#.#.#######.#.###.#####.###.#.###.#.###.#######.#.#.###.#######.###########.#.#.###.#.###.#.#####.###.#####.###.#.#.#.###.#
#...#...#.....#.#...#.#.....#.#.#...#.....#...#.....#...#.........#.#.#.........#.......#...#...#.....#...#.#...........#...#...#...#.......#
#####.###.#.###.#####.#.#.###.###.###.#####.#######.###.###.#######.#.#########.#.#.###.###.#.#########.###.#########.###.#.###.#######.###.#
#.....#...#.....#.....#.#.......................#...#...#.........#.#.......#...#.#...#...#.#.......#...#...#.........#...#...#.......#.....#
#.#####.#.#######.#################.#########.#.#.###.###.#####.#.#.#######.#####.###.###.#.#.#.###.#.#.#.###.###.#####.#####.#######.#.#####
#.#.#...#...#.................#.#...#.........#.......#.#.#.#...#...#...#...#...#.......#.#.#.#...#...#.#.....#...#...#...#.........#.......#
#.#.#.#.#.###.###.###########.#.#.###.#################.#.#.#.#####.#.#.#.###.#.#########.#.#.###.#####.#######.###.#.###.#########.###.###.#
#.#.#...#.........#.....#.....#.#.#.....#...#.............#.#.#.....#.#.......#.........#.#.#...#.........#.......#.#...#...#.....#.#.....#.#
#.#.###.#.#######.#####.#.#####.#.#.###.#.#.###.###.###.#.#.#.#######.#################.#.#.###.#.#.#####.#.#######.###.###.#.###.#.#.###.#.#
#.#...#.#.....#.........#.#.....#.#.#...#.#...#...#...#.#.....#.......#.........#.......#.#...#.#.#.....#.#.#...#...#...#...#...#.#...#.#.#.#
#.#.###.#.###.###########.#.###.#.###.###.###.#######.###.#.#.#.###############.#.#######.#.#.#.###.###.#.#.#.#.#.###.#.#.#####.#.#####.#.#.#
#.#.....#.#...............#.#...#...#...#...#.#.....#.......#...........#.....#.#.#.......#.#.#.....#.#.#.#...#.#.#.......#.....#.......#...#
#.#.###.#.#.#################.###.#.#.#.###.#.#.###.#######.###########.#.###.#.#.#.###.#.###.###.#.#.#.###.#####.#.###########.#.#####.###.#
#.#...#...#.#...#...#.........#...#.#.#...#.#...#.#.#.....#.#.....#...#.#...#...#...#.#...#...#...#...#.....#.....#.....#.......#.....#...#.#
#.###.#.#####.#.#.#.#####.#.###.#.#.###.#.#.#####.#.#.###.###.###.#.#.#.###.#########.#####.#.#.#####.###.#.#.#######.###.#####.#####.###.#.#
#.#...#.......#.#.#...#...#.#...#...#.....#...#...#...#.#.....#.#...#.#...#.#.#.......#.......#.....#.......#.#.#.....#...#...#.#.....#...#.#
#.#.###.###.###.#.###.#.###.#.#######.#.#####.#.#.#####.#######.#####.###.#.#.#.###.#.#.#####.#####.#########.#.#.#####.###.#.#.###.###.#.#.#
#.#.#.....#.....#.#.....#.#.#.........#.......#.#.........#.............#.#.#.....#.#.#.#.....#.....#.......#.#...#...#.#...#.#...#...#.#.#.#
#.#.#.#.#.#.#####.#######.#.#####.#####.#.#########.###.#.#.#####.#####.#.#.#######.#.###.###.#.#.###.#####.#.###.#.#.#.###.#.#.#.#.#.#.#.#.#
#.#...#.#...#...............#...#.#...#.#.#.......#...#.#.#...#.......#.#.#.#.......#.#...#.#.#.#.......#...#.......#.......#...#.#.#...#.#.#
#.#####.#.#.###.#######.#####.#.#.#.#.###.#.#####.#####.#.#.#.#.#.###.#.#.#.#.#######.#.###.#.#.#######.#.###.###########.#####.#.#.#######.#
#.....#...#...#.#...#...#.....#...#.#.#...#.#...........#.#...#.#...#.#.#.#.#...#...#...#.#...#.........#.#.....#...#.............#.#.......#
#.#.#.#.###.#.###.#.#.###.#.#######.#.#.###.#.#.#########.#.#.#.###.#.#.#.#.#.#.#.#.#####.#.#########.###.#.#####.#.#.#########.###.#.#######
#.#.#.......#.#...#.#.....#.......#.#...#...#.#.#.......#...#.#.#...#...#.#...#...#.#.........#.......#...#...#...#.#.#...#.....#...#...#...#
#.#.###.#####.#.###.#.#########.###.#######.#.###.#####.###.###.#.###.#######.#####.#.#######.###.#.###.#####.#.###.#.#.###.###.#.#.###.###.#
#...#...........#.#.#...........#...#.......#.........#.....#...#...#.#.....#.....#.......#...#...#.#...#.....#.#.....#...#...#.#.#...#.....#
#.###.#.###.#.#.#.#.###########.#.###.#.#################.###.#####.#.#.###.#####.#.#####.#.###.###.#.#####.###.#######.#.###.#.#.###.#####.#
#.....#.....#.....#.......#.....#...#.#...#.............#...#.....#.#.#...#.....#.#.....#.#.....#...#.#...#...#.....#...#.....#.#.#.#.....#.#
#.#######.###########.###.#.#######.#.###.#.###.#.#####.#########.#.#.###.###.#.#.###.###.#######.###.#.#.#.#######.#.#########.#.#.###.#.#.#
#.#.....#.......#...#...#.#...#.........#...#.#...#...#...........#.....#...#.....#...#...#.........#...#.#.#.......#.#.#.....#...#...#.#.#.#
#.#.###.#########.#.###.#.###.#.#######.#####.#.###.#########.#.#.#########.#######.###.###.#######.#####.###.#######.#.#.###.#.###.#.#.###.#
#.#.#.#...........#.#...#.#...#...#...#...........#.....#...#.#.#...#.....#.....#.....#.#.....#...#.#...#.....#.....#.#.....#.......#.#.#...#
#.#.#.#############.#####.#.#####.#.###.#.#########.###.#.#.#.#####.#.#.#####.#.#######.###.###.#.#.#.#.#######.###.#.#############.###.#.###
#.#.#...#...#.......#.....#.#.#...#.#...#.......#.....#.#.#.#.....#...#.....#...#.....#.....#...#.#...#...#.....#...#.............#...#...#.#
###.#.###.#.#.#######.#####.#.#.#.#.#.#####.###.#.###.#.#.#.#.#.#########.#.#.###.###.###.#.#.###.#.#####.###.###.###############.###.#####.#
#...#...#.#.#...#...#.........#.#.........#...#...#...#.#.#.#.#.............#.....#.#...#.#...#...#.#...#.....#...#.......#.....#...#.......#
#.###.#.#.#.#.#.#.#.###.#####.#.#########.#.#.#####.#.#.#.#.#######.###.#.#########.###.#.#####.#.###.#.#######.###.#####.#.#.#.###.#.#####.#
#.................#...#.....#.#.....#.#...#.#.....#.#.#.#.#.........#...#.....#.......#.#.#.....#.#...#.#.........#.....#.#...#.#.#...#...#.#
#.#.#.#.#####.#.#.###.#####.#######.#.#.###.#####.#.#.#.#.#########.#######.#.#.#####.#.#.#.#####.#.###.#.#.#####.#####.###.#.#.#.#####.###.#
#...........#...#.#.........#...#...#.#...#.....#...#.#.#...#.....#.#.....#.#...#.#...#.#.#.#.....#.#.#.#.#.#...............#.#.......#.....#
#.###.#.###.#.###.#########.#.#.#.###.###.#####.#####.#.###.#####.#.#.###.#.###.#.#.#.#.#.#.#.#####.#.#.###.#.###########.###.#########.#####
#.#.........#.....#.........#.#.#.#.#.....#...#...#.#.....#.....#...#.#...#.#.....#...#.#.#.#.#.....#.#...#.#.#...#.......#.#...#.......#...#
#.###.#.#.###.###.#.#####.###.#.#.#.#.#####.#.#.#.#.#####.#####.#.###.#.###.#.###.###.#.###.#.#.#####.###.#.#.#.###.#######.###.#.#########.#
#.......#...#.......#...#.#...#.#.#...#.....#.#.#.#.....#.#...#.#...#.#.#...#...#...#.#...#.#.#.#.......#.#.....#...#.....#...#...#.#.......#
#####.#.###.#.#####.#.###.#.###.#.###.###.###.###.#.###.#.#.#.#.###.#.#.###.###.#####.###.#.#.#.#.#.###.#.#######.#####.#.###.#####.#.###.#.#
#.......#.....#.....#...#.#.#...#...#.....#.#.#...#...#.#.#.#.#.#...#.#.......#.#.....#...#.#.#.#.#...#.#...#.....#.....#...#...#.......#...#
#.#####.#######.#####.#.#.#.#.#####.#######.#.#.#####.#.#.###.#.#####.#.#.###.#.#.#####.###.###.###.#.#.###.#.#####.#######.#.###.#########.#
#.#.....#.......#.....#.#.#.#.......#...........#...#.#.#.....#.....#...#.....#.#.....#.#.#...#.....#.....#.........#.....#.#.....#.....#...#
#.#.###.#.#######.#.###.#.#.#########.###########.#.#.#.#####.#####.###.#######.#.#####.#.#.#.#######.#####.###.#.###.#.###.#.#.###.###.#.#.#
#.#.#.....#.....#.#...#.#.#.....#...#...#...#.#...#.#.#.....#.#.......#.....#.....#...#.#.#.#.........#.....#.#.#...#.#.....#...#...#.#...#.#
#.#.#.#.###.#####.#.#.#.#.#####.#.#.#####.#.#.#.###.#.###.###.#.###.#.#####.#######.#.#.#.#.###.#####.#.###.#.#.#.#.#.###.#.###.#.###.#####.#
#.#.#.#.....#...#...#.#.#.....#...#.......#.#.#.#.#.#.#.#.....#.#.......#.#.#.....#.#.....#.#.......#.#.#...#.#.#...#...#.#...#...#.......#.#
#.#.#.#.#####.#.#.#.#.#.###.###.###########.#.#.#.#.#.#.#######.#.#####.#.#.#.###.#.#####.#.#.#####.#.#.#.###.#.#.#.#####.###.#.###.#####.#.#
#...#.#.......#.#...#.#.....#...#.........#.#.#...#.#.......#.#.#.#...#...#...#...#...#...#.#.....#...#.#.....#.#.#.....#...#...#.#.#.......#
#.###.#.#######.#####.###.#.#.#.#.#####.###.#.###.#.#######.#.#.###.#.###.#####.#.###.#.#.#.###.#.###.#.#####.#.#.#####.#.#.###.#.#.#.#.###.#
#.#...#.#...#...#...#...#.#...#.#.....#.....#.....#.......#...#.....#.#.#.#.....#...#.#.#...#...#.#.......#...#.#.....#.#.........#.#.#.....#
#.#.###.#.#.#.#.#.#.###.#.#####.#.#.#.#######.#####.#.#####.#.#######.#.#.#.#########.#.#####.#.#.#.#####.#.#.#.#####.#.###.#.#.###.#.#####.#
#.#.#...#.#.#.#.#.#.....#...#...#...#.#.......#...#.#.#.....#...#...#.#...#.....#...#.#.......#.#.........#.#.#.......#...#.#...#...#.......#
#.#.#.###.#.#.#.#.#######.###.#.#####.#########.#.###.#.#####.#.###.#.#########.#.#.#.###.#.#####.#########.#.#######.#.#.#####.#.#########.#
#...#.....#.#.#.#...#...#...#.#.....#.........#.#...#.#.#.....#.....#.#.........#.#...#.#.#.....#.#...#.....#.......#.#.#...#...#.#.....#...#
###########.#.#.###.#.#.###.#.###.###########.#.###.#.#.#.#######.###.#.#######.#.#####.#.#.###.#.#.###.###.#######.#.#.###.#.#.#.#.#.#.#.#.#
#.#.......#.#.#...#.#.#...#.#.....#.......#.#.#.......#.#.........#...#.........#.....#...#.#.....#.#.....#.......#.#.#...#.#.#...#.#.#.#.#.#
#.#.#####.#.#.###.#.#.#.#.#.#####.#.#.###.#.#.#.#.###.#.###.###.#.#.#.#######.#####.#.#.###.###.###.#.#####.#####.#.#.###.#.#.#.#####.#.#.#.#
#.......#.#.#...#.#.#.#.#.#...#.....#...#...#.#.#.#...#...#...#...#.#.#.....#.#.........#.#...........#...#...#.#...#.#...#.#.......#.#...#.#
#########.#.###.#.#.#.#.#.#.#.#.#####.#.#.###.#.#.#######.#.#.#####.#.#.#.###.#.#####.###.#####.#######.#.###.#.#####.#.###.#######.#.#####.#
#.......#...#...#.#.#.#.#.#.#.........#...#...#.#.#...#...#.#.....#.#.#.#...#...#...#.#...#...#.......#.#.#.........#.#...#...#.#...........#
#.#####.#####.###.#.#.#.###.#########.###.#.#####.#.#.#.#########.#.#.#.###.#####.#.#.#.#.#.#.#.#####.#.#.###########.#######.#.#.###.#.#####
#...#.........#...#.#.#...#.#.......#...#...#.....#.#...#.........#.#.#...#.#.....#.#.#.#.#.#.......#.#.#.........#...#.....#.#.............#
#.#.###########.###.###.#.#.#######.#.#.#####.#####.#####.#######.#.#.#.#.#.#.###.#.#.#.#.#.#######.#.#.#########.#.###.###.#.#.#.#####.###.#
#.#.#.......#.............#.....#...#.....#.......#.#.....#...#...#.#.#...........#.#.#.#.#.#...#...#...#.#.......#.#...#.......#.........#.#
###.#.#####.###.#.###.###.###.#.#.###.#.###.#####.#.#.###.#.#.#.###.#.#.#######.###.#.###.#.###.#.#######.#.#######.#.#.#######.#######.#.#.#
#...#.....#...#.....#.#...#...#.#.....#...#...#...#.#.#...#.#.#...#.#.#...#.#...#...#...#.#.....#.....#.......................#...#.....#.#.#
#.#######.###.#.###.#.#.#.#.#.#.#.###.#.#.###.#.###.#.#.###.#.###.#.#.###.#.#.#########.#.###.#####.#.###.#.#.###.#.#########.#.#.#.###.#.#.#
#.......#.#.#...#...#...#...........................#.#.#...#.#...#.#...#...#.....#...#.#.....#.....#...#.#.#...................#.#.#...#...#
#.#.###.#.#.###.#.#.#########.#.###.#.#.###.#.#########.#.#.###.###.#######.#####.#.#.#.#.#####.#######.#.#.###.#.#########.#.#.###.#.#.###.#
#.#.#.#...#...#.#.#.......................#.#.#.........#.#.#...#.#.#.....#.#...#...#...#...#...#.......#.#.....#...#.......#.#.#...#.....#.#
#.#.#.#####.#.#.###.###########.#########.#.#.#####.#####.#.#.###.#.#.#.###.#.#.#############.###.#######.#########.#.#######.#.#.#####.#.#.#
#S..........#.#...........................#.........#.....#.......#...#.......#...............#...................#...........#.........#...#
#############################################################################################################################################